 #####      
 #I ###     
 # O  #     
### # ##    
#X# #  #    
#XO  # #    
#X   O #    
########    
            
            
            
             