            
            
            
 #######    
 #     ###  
##O###   #  
# I O  O #  
# XX# O ##  
##XX#   #   
 ########   
            
             