            
            
            
 #########  
 #  ##   #  
 #   O   #  
 #O ### O#  
 # #XXX# #  
## #XXX# ## 
# O  O  O # 
#     # I # 
###########  