 ####       
##  #       
#IO #       
##O ##      
## O #      
#XO  #      
#XX X#       
######      
            
            
            
             