#####       
#I  #       
# OO# ###   
# O # #X#   
### ###X#   
 ##    X#   
 #   #  #   
 #   ####   
 #####      
            
            
            